11111111111111111111
10000000000000000006
10111011101111101101
10111011101111101101
10111011101111101101
10000000001111101101
11110111100000011101
11110111101101111101
11110111000001111101
11110000000000000001
11110011111111111101
11101111111111111101
11000011111111111101
11001101111111111101
10000000000000000001
11111111111111111111