11111111111111111111
11111110000000000006
11111110111111110101
11111110111111111001
11111110111111110001
11111110111111110111
10000000001111110111
10110111101111110111
10110111101111110111
10000111101110000001
10110000001110111101
10100111101000111101
10000000000011111101
10010111101011111101
10010111100000000001
11111111111111111111