11111111111111111111
11111111011111111106
10000000000000000101
10001111111110110101
10100000000000000001
11111111111101111101
10000001000000000001
10111111111110100001
10000000000000011101
11111111111111111101
10000000000000000001
10110011111111110101
10000000000000011101
10001111101100111101
10101111111111100001
11111111111111111111