11111111111111111111
10001111110000000006
10101101111010111101
10101101111010011101
10101101111101011101
10101101111101011101
10101101110010011101
10101101110101111101
10101101101110111101
10000101111101111101
11010111110111111101
11010111110111111101
11010111001111111101
10111100111111111101
10000111111111111101
11111111111111111111