11111111111111111111
10000000000000000006
10111111111111111101
10111111111111111101
10000000000000000001
10111111111111111101
10111111111111111101
10111111111111111101
10111111111111111101
10111111111111111101
10111111111111111101
10000000000000000001
10111111111111111101
10111111111111111101
10000000000000000001
11111111111111111111