11111111111111111111
11111111000011000006
11111111010111011101
11111111111011011101
11110000010000011101
11110111010111011101
11110001010111000001
11111011000111110111
11111011000111110111
10010011111111110111
11010110000011110001
10000110111000111111
10110000100000111111
10111111101111111111
10000000001111111111
11111111111111111111
